g	w	r	g	w	w	t	t	g	t	g	c	g	r	w	w	g	g	c	g	t	t	w	w	w	r	w	w	g	t	
g	g	r	r	r	r	r	r	r	r	r	r	r	g	g	g	g	g	w	g	w	t	t	c	c	r	r	r	r	r	
r	r	g	r	c	r	w	r	g	r	g	r	g	t	t	g	g	w	t	w	t	w	g	c	w	r	t	r	g	r	
w	r	r	g	t	r	r	g	t	r	r	t	g	t	w	g	g	w	c	w	w	w	t	g	g	r	r	t	t	r	
w	r	w	w	t	r	g	t	t	r	g	w	g	w	g	g	g	t	g	t	t	g	g	w	t	r	g	g	t	r	
r	t	g	g	w	r	r	r	r	t	t	t	g	t	c	t	t	g	g	g	t	w	g	c	w	r	r	r	r	w	
t	g	t	w	g	r	c	r	w	t	t	t	w	g	c	g	t	w	g	w	t	t	w	t	g	r	t	r	c	g	
t	g	g	g	c	r	r	c	w	w	w	w	t	g	t	g	t	g	g	c	w	t	t	t	c	r	r	w	w	g	
r	r	r	r	r	g	r	r	r	r	r	r	r	r	r	r	r	r	r	r	r	r	r	r	r	w	r	r	r	r	
t	r	t	r	w	t	r	w	r	w	r	g	r	t	r	g	r	g	r	g	r	w	r	g	r	r	c	r	w	r	
g	r	r	g	w	w	r	r	w	w	r	r	g	g	r	r	c	g	r	r	t	g	r	r	g	r	r	w	g	r	
g	r	w	w	t	w	r	g	t	w	r	t	g	g	r	t	t	g	r	g	g	g	r	g	g	r	t	w	g	r	
w	r	r	r	r	r	t	w	g	t	r	r	r	r	g	t	t	g	r	r	r	r	w	c	g	r	r	r	r	t	
g	r	t	r	w	r	r	r	r	r	t	r	t	r	r	r	r	r	g	r	g	r	r	r	r	g	r	g	r	r	
g	r	r	g	g	r	w	r	t	r	r	g	g	r	w	r	w	r	r	g	c	r	c	r	w	t	r	r	g	r	
w	r	g	g	w	r	r	t	t	r	t	g	t	r	r	g	g	r	g	w	t	r	r	w	t	t	r	w	w	r	
w	r	r	r	r	t	r	r	r	g	c	w	w	r	t	g	g	r	r	r	r	w	r	r	r	r	w	c	g	r	
g	r	g	r	t	t	r	w	r	r	r	r	r	g	t	g	t	r	g	r	w	t	r	t	r	c	w	t	c	r	
c	r	r	w	g	t	r	r	g	r	t	r	t	g	g	c	w	r	r	g	w	t	r	r	t	g	w	w	t	r	
g	r	c	t	t	w	r	c	g	r	r	w	t	t	t	g	t	r	g	g	t	g	r	g	g	g	g	t	g	r	
t	r	r	r	r	r	g	t	g	r	w	g	w	t	g	g	w	r	r	r	r	r	t	t	g	t	g	w	g	r	
t	r	g	r	g	r	r	r	r	w	g	t	g	c	w	t	g	r	t	r	g	r	r	r	r	r	r	r	r	w	
g	r	r	w	c	r	t	r	t	t	g	g	t	t	w	t	g	r	r	c	g	r	g	r	g	r	g	r	t	g	
c	r	g	t	g	r	r	g	w	w	c	g	g	c	w	w	c	r	g	g	c	r	r	c	t	r	r	g	g	t	
g	r	r	r	r	g	r	r	r	r	r	r	r	r	r	r	r	g	g	g	t	r	g	w	t	r	g	g	w	g	
g	r	g	r	g	t	r	t	r	t	r	c	r	g	r	c	r	r	r	r	r	t	t	t	g	r	r	r	r	r	
w	r	r	t	c	w	r	r	g	g	r	r	g	t	r	r	w	r	g	r	g	g	g	g	g	r	c	r	g	r	
t	r	w	g	t	w	r	g	t	t	r	t	g	t	r	g	g	r	r	g	w	w	c	w	g	r	r	t	g	r	
g	r	r	r	r	r	c	g	t	g	r	r	r	r	g	c	w	r	t	t	g	g	t	c	t	r	c	w	t	r	
t	r	w	r	g	r	r	r	r	r	g	r	t	r	r	r	r	g	c	w	g	t	c	w	g	r	r	r	r	g	