r	c	g	t	g	g	t	t	c	t	g	t	g	w	g	g	r	g	g	r	r	g	r	t	r	r	g	r	g	g	
t	g	t	t	c	g	t	c	w	g	w	g	t	t	g	g	r	r	r	w	r	r	g	g	r	w	g	r	r	r	
g	t	g	g	c	g	g	t	g	w	t	c	t	t	c	t	r	w	r	r	g	r	r	r	g	w	g	r	t	r	
g	g	w	g	w	t	t	t	c	g	w	g	g	g	w	w	r	r	g	r	r	g	r	c	t	w	t	r	r	t	
t	w	c	g	g	c	w	g	g	g	c	c	g	g	t	g	r	t	w	r	g	w	r	r	r	r	r	g	r	r	
g	c	t	g	t	t	t	t	c	w	t	g	c	t	w	w	r	r	r	w	w	t	r	w	r	t	r	r	w	r	
t	w	w	g	w	g	g	g	t	t	w	w	g	w	t	w	r	w	r	r	r	r	w	t	r	r	w	r	r	g	
t	w	g	t	g	c	w	t	g	w	t	c	t	g	t	t	r	r	w	r	g	r	r	r	g	r	r	w	r	r	
g	g	g	c	w	w	c	c	t	w	g	g	g	g	g	c	r	t	g	r	r	g	r	g	g	r	g	t	r	t	
g	g	g	w	g	g	w	g	g	w	t	g	w	g	w	g	r	r	r	w	r	r	w	w	g	r	r	r	w	w	
g	t	w	t	g	t	g	g	w	g	g	t	t	w	g	c	r	t	r	r	g	r	r	r	r	w	r	c	w	w	
g	w	g	t	t	w	t	w	t	w	w	g	w	w	g	t	r	r	w	r	r	g	r	w	r	r	t	t	g	w	
g	t	g	g	g	t	w	w	g	t	c	w	g	g	g	g	r	t	g	r	t	t	r	r	g	r	r	r	r	r	
t	w	w	c	t	t	t	t	t	w	c	w	w	c	w	c	r	r	r	t	t	g	r	t	w	r	w	r	w	r	
r	r	r	r	r	r	r	r	r	r	r	r	r	r	r	r	g	r	c	t	t	t	r	r	r	g	g	r	r	t	
t	r	t	r	g	r	g	r	g	r	w	r	g	r	g	r	r	g	w	g	c	w	r	g	r	r	r	t	r	r	
r	w	g	r	r	g	w	r	r	g	c	r	r	g	g	r	g	g	g	c	g	t	r	r	w	r	g	w	r	t	
r	r	r	w	r	r	r	g	r	r	r	g	r	r	r	w	t	c	w	t	c	w	r	g	g	r	r	r	g	w	
t	r	g	c	r	g	r	r	g	r	g	w	r	t	r	r	r	r	r	r	r	r	t	w	w	r	c	r	r	r	
g	r	r	r	t	g	r	w	w	r	r	r	c	g	r	w	r	g	r	w	r	g	t	t	g	r	r	w	r	g	
w	r	w	r	r	r	w	c	w	r	w	r	r	r	g	g	r	r	g	t	r	r	r	r	r	g	r	r	t	g	
g	r	r	g	r	t	w	w	w	r	r	w	r	t	c	t	r	w	g	g	r	g	r	t	r	r	g	r	r	r	
g	r	w	t	r	r	r	r	r	t	r	r	w	g	c	c	r	r	r	r	g	g	r	r	g	r	r	t	r	g	
g	r	r	r	w	r	t	r	t	g	r	g	g	w	g	g	r	w	r	t	w	t	r	g	g	r	g	g	r	r	
g	r	w	r	r	g	w	r	r	r	t	t	w	t	g	w	r	r	w	g	t	g	r	r	r	w	w	c	r	t	
g	r	r	t	r	r	r	g	r	t	t	c	t	g	t	g	r	w	w	w	c	w	r	t	r	r	r	r	t	g	
g	r	g	g	r	c	r	r	g	g	c	g	g	g	w	w	r	r	r	r	r	r	g	t	r	t	r	w	w	t	
g	r	r	r	t	w	r	g	t	g	g	g	w	g	t	g	r	w	r	w	r	g	w	w	r	r	t	g	g	g	
g	r	w	r	r	r	t	t	w	g	t	t	w	w	g	t	r	r	g	w	r	r	r	r	w	r	r	r	r	r	
r	g	t	r	t	r	r	r	r	r	r	r	r	r	r	r	g	r	r	r	g	r	g	r	r	g	r	w	r	g	