w	r	w	r	w	r	w	r	w	r	w	r	w	r	c	c	t	r	t	r	t	r	t	r	t	r	t	r	t	r
r	r	r	r	r	r	r	r	r	r	r	r	r	r	c	c	r	r	r	r	r	r	r	r	r	r	r	r	r	r
w	r	w	r	w	r	w	r	w	r	w	r	w	r	c	c	t	r	t	r	t	r	t	r	t	r	t	r	t	r
r	r	r	r	r	r	r	r	r	r	r	r	r	r	c	c	r	r	r	r	r	r	r	r	r	r	r	r	r	r
w	r	w	r	w	r	w	r	w	r	w	r	w	r	c	c	t	r	t	r	t	r	t	r	t	r	t	r	t	r
r	r	r	r	r	r	r	r	r	r	r	r	r	r	c	c	r	r	r	r	r	r	r	r	r	r	r	r	r	r
w	r	w	r	w	r	w	r	w	r	w	r	w	r	c	c	t	r	t	r	t	r	t	r	t	r	t	r	t	r
r	r	r	r	r	r	r	r	r	r	r	r	r	r	c	c	r	r	r	r	r	r	r	r	r	r	r	r	r	r
w	r	w	r	w	r	w	r	w	r	w	r	w	r	c	c	t	r	t	r	t	r	t	r	t	r	t	r	t	r
r	r	r	r	r	r	r	r	r	r	r	r	r	r	c	c	r	r	r	r	r	r	r	r	r	r	r	r	r	r
w	r	w	r	w	r	w	r	w	r	w	r	w	r	c	c	t	r	t	r	t	r	t	r	t	r	t	r	t	r
r	r	r	r	r	r	r	r	r	r	r	r	r	r	c	c	r	r	r	r	r	r	r	r	r	r	r	r	r	r
w	r	w	r	w	r	w	r	w	r	w	r	w	r	c	c	t	r	t	r	t	r	t	r	t	r	t	r	t	r
r	r	r	r	r	r	r	r	r	r	r	r	r	g	g	g	g	r	r	r	r	r	r	r	r	r	r	r	r	r
c	c	c	c	c	c	c	c	c	c	c	c	c	g	g	g	g	c	c	c	c	c	c	c	c	c	c	c	c	c
c	c	c	c	c	c	c	c	c	c	c	c	c	g	g	g	g	c	c	c	c	c	c	c	c	c	c	c	c	c
t	r	t	r	t	r	t	r	t	r	t	r	t	g	g	g	g	w	r	w	r	w	r	w	r	w	r	w	r	w
r	r	r	r	r	r	r	r	r	r	r	r	r	r	c	c	r	r	r	r	r	r	r	r	r	r	r	r	r	r
t	r	t	r	t	r	t	r	t	r	t	r	t	r	c	c	r	w	r	w	r	w	r	w	r	w	r	w	r	w
r	r	r	r	r	r	r	r	r	r	r	r	r	r	c	c	r	r	r	r	r	r	r	r	r	r	r	r	r	r
t	r	t	r	t	r	t	r	t	r	t	r	t	r	c	c	r	w	r	w	r	w	r	w	r	w	r	w	r	w
r	r	r	r	r	r	r	r	r	r	r	r	r	r	c	c	r	r	r	r	r	r	r	r	r	r	r	r	r	r
t	r	t	r	t	r	t	r	t	r	t	r	t	r	c	c	r	w	r	w	r	w	r	w	r	w	r	w	r	w
r	r	r	r	r	r	r	r	r	r	r	r	r	r	c	c	r	r	r	r	r	r	r	r	r	r	r	r	r	r
t	r	t	r	t	r	t	r	t	r	t	r	t	r	c	c	r	w	r	w	r	w	r	w	r	w	r	w	r	w
r	r	r	r	r	r	r	r	r	r	r	r	r	r	c	c	r	r	r	r	r	r	r	r	r	r	r	r	r	r
t	r	t	r	t	r	t	r	t	r	t	r	t	r	c	c	r	w	r	w	r	w	r	w	r	w	r	w	r	w
r	r	r	r	r	r	r	r	r	r	r	r	r	r	c	c	r	r	r	r	r	r	r	r	r	r	r	r	r	r
t	r	t	r	t	r	t	r	t	r	t	r	t	r	c	c	r	w	r	w	r	w	r	w	r	w	r	w	r	w
r	r	r	r	r	r	r	r	r	r	r	r	r	r	c	c	r	r	r	r	r	r	r	r	r	r	r	r	r	r