t	r	t	r	t	r	t	r	t	r	t	r	t	r	t	r	t	r	t	r	t	r	t	r	t	r	t	r	t	r
r	r	r	r	r	r	r	r	r	r	r	r	r	r	r	r	r	r	r	r	r	r	r	r	r	r	r	r	r	r
t	r	t	r	t	r	t	r	t	r	t	r	t	r	t	r	t	r	t	r	t	r	t	r	t	r	t	r	t	r
r	r	r	r	r	r	r	r	r	r	r	r	r	r	r	r	r	r	r	r	r	r	r	r	r	r	r	r	r	r
t	r	t	r	t	r	t	r	t	r	t	r	t	r	t	r	t	r	t	r	t	r	t	r	t	r	t	r	t	r
r	r	r	r	r	r	r	r	r	r	r	r	r	r	r	r	r	r	r	r	r	r	r	r	r	r	r	r	r	r
t	r	t	r	t	r	t	r	t	r	t	r	t	r	t	r	t	r	t	r	t	r	t	r	t	r	t	r	t	r
r	r	r	r	r	r	r	r	r	r	r	r	r	r	r	r	r	r	r	r	r	r	r	r	r	r	r	r	r	r
t	r	t	r	t	r	t	r	t	r	t	r	t	r	t	r	t	r	t	r	t	r	t	r	t	r	t	r	t	r
r	r	r	r	r	r	r	r	r	r	r	r	r	r	r	r	r	r	r	r	r	r	r	r	r	r	r	r	r	r
t	r	t	r	t	r	t	r	t	r	t	r	t	r	t	r	t	r	t	r	t	r	t	r	t	r	t	r	t	r
r	r	r	r	r	r	r	r	r	c	c	r	c	r	c	r	c	c	r	r	r	r	r	r	r	r	r	r	r	r
t	r	t	r	t	r	t	r	t	c	w	r	w	r	w	r	w	c	t	r	t	r	t	r	t	r	t	r	t	r
r	r	r	r	r	r	r	r	r	r	r	r	r	r	r	r	r	r	r	r	r	r	r	r	r	r	r	r	r	r
t	r	t	r	t	r	t	r	t	c	w	r	w	r	w	r	w	c	t	r	t	r	t	r	t	r	t	r	t	r
r	r	r	r	r	r	r	r	r	r	r	r	r	r	r	r	r	r	r	r	r	r	r	r	r	r	r	r	r	r
t	r	t	r	t	r	t	r	t	c	w	r	w	r	w	r	w	c	t	r	t	r	t	r	t	r	t	r	t	r
r	r	r	r	r	r	r	r	r	r	r	r	r	r	r	r	r	r	r	r	r	r	r	r	r	r	r	r	r	r
t	r	t	r	t	r	t	r	t	c	w	r	w	r	w	r	w	c	t	r	t	r	t	r	t	r	t	r	t	r
r	r	r	r	r	r	r	r	r	c	c	r	c	r	c	r	c	c	r	r	r	r	r	r	r	r	r	r	r	r
t	r	t	r	t	r	t	r	t	r	t	r	t	r	t	r	t	r	t	r	t	r	t	r	t	r	t	r	t	r
r	r	r	r	r	r	r	r	r	r	r	r	r	r	r	r	r	r	r	r	r	r	r	r	r	r	r	r	r	r
t	r	t	r	t	r	t	r	t	r	t	r	t	r	t	r	t	r	t	r	t	r	t	r	t	r	t	r	t	r
r	r	r	r	r	r	r	r	r	r	r	r	r	r	r	r	r	r	r	r	r	r	r	r	r	r	r	r	r	r
t	r	t	r	t	r	t	r	t	r	t	r	t	r	t	r	t	r	t	r	t	r	t	r	t	r	t	r	t	r
r	r	r	r	r	r	r	r	r	r	r	r	r	r	r	r	r	r	r	r	r	r	r	r	r	r	r	r	r	r
t	r	t	r	t	r	t	r	t	r	t	r	t	r	t	r	t	r	t	r	t	r	t	r	t	r	t	r	t	r
r	r	r	r	r	r	r	r	r	r	r	r	r	r	r	r	r	r	r	r	r	r	r	r	r	r	r	r	r	r
t	r	t	r	t	r	t	r	t	r	t	r	t	r	t	r	t	r	t	r	t	r	t	r	t	r	t	r	t	r